##########
#........#
#........#
#........#
#........#
#........#
#........#
#........#
#........#
####E#####
